 # # # # # # # # # # # #
 # . . . . . . . . . . #
 # . # . # . # # # # . #
 # # # . # . . . . # . #
 # . . . . # # # . # . #
 # # # # . # F . . # . #
 # # # # # # # # # # . #
